Rows:10
Cols:15
Tiles:
000000000000000
000000000000000
000000000010000
000000000000000
000000011000000
000000000010110
000111000011110
000011000000000
000010000000000
000000000000000