Rows:10
Cols:19
Tiles:
0000000000000000000
0000000000000000000
0000000000100000000
0000000000000000000
0000000110000000000
0000000000101100000
0001110000111100000
0000110000000000000
0000100000000000000
0000000000000000000